NO ./assets/world/wall.xpm
SO ./assets/world/wall.xpm
WE ./assets/world/wall.xpm
EA ./assets/world/wall.xpm

F 14,5,58
C 10,0,10

11111111111111111
10000000100000001
10110110101101101111111
10000000000000001
10110101110101101
10000100100100001 1111111
11110110101101111 1000001
11110100000100001 1011101
1E000001110200001 101 101
11110100000100001 1011101
11110110101101111 1000001
10000100100100001 1111111
10110101110101101
10000000000000001
10110110101101101
10000000100000001
11111111111111111
