NO ./assets/maps/wolfenstein/eagle.xpm
SO ./assets/maps/wolfenstein/color_stone.xpm
WE ./assets/maps/wolfenstein/blue_stone.xpm
EA ./assets/maps/wolfenstein/red_brick.xpm
DO ./assets/maps/made/made_door.xpm

F 220,100,0
C 225,30,0

        1111111111111111111111111
        1000000000110000000000001
        1211000001110000000000001
        1001000000020000000000001
111111111011000001110000000000001
100000000011000001110111112111111
11112111111111011100000010001
11110111111111211101010010001
11000000110101011100000010001
10000000000000002000000020001
10000000000000001101010010001
11000001110101011111011110N0111
11110111 1110101 101111010001
11111111 1111111 111111111111
