NO assets/maps/scifi/1.xpm
SO assets/maps/scifi/5.xpm
WE assets/maps/scifi/3.xpm
EA assets/maps/scifi/2.xpm
DO assets/maps/scifi/4.xpm

C 153,204,255
F 20,20,20

1111111111111111111111
100S001000000000100001
1000001000000000200001
1000001000000000100001
1000001111110000100001
1000000000010000100001
1000000000010000100001
1000000000010000100001
1000000000010000100001
1111111112110000100001
1000000100010000100001
1000000100010000100001
1000000000010000100001
1000000000010000100001
1000000000010000100001
1110000000010000111121
1111211111110000100001
1110000000000000100001
1110000000000000100001
1110000000000000100001
1111111111111111111111
