NO assets/maps/matrix/matrix.xpm
SO assets/maps/matrix/matrix.xpm
WE assets/maps/matrix/matrix.xpm
EA assets/maps/matrix/matrix.xpm

F 0,0,0
C 0,0,0

111111111111111111111
101000000000000010001
101000000000000010001
101000000000000010001
101000000000000010001
101000000000000010001
101000000000000010001
101000000000000010001
101000000000000010001
101000000000000010001
101000000000000010001
101000000000000010001
101000000000000010001
101000000000000010001
101000000000000010001
101000000000000010001
101000000000000010001
101000000000000010001
101000000000000010001
101000000000000010001
101000000000000010001
101000000000000010001
101000000000000010001
101000000000000010001
101000000000000010001
101000000000000010001
10100000100N000000001
111111111111111111111
