NO ./assets/world/wall.xpm
SO ./assets/world/wall.xpm
WE ./assets/world/wall.xpm
EA ./assets/world/wall.xpm
F 160,95,165
C 152,255,242
111111111111111
10001E100010001
110001100000001
100000000001001
110000001100011
100000001011001
100100000000001
100011101010011
110101002011011
101100011101011
100100001001001
100000001000001
100010000011001
100020001001011
111111111111111
