NO ./assets/world/wall.xpm
SO ./assets/world/wall.xpm
WE ./assets/world/wall.xpm
EA ./assets/world/wall.xpm
F 91,224,86
C 139,47,170
111111111111111
100110000101111
101101000002001
100001210001001
110000001000111
1W1000000000111
100000100000001
101000011100001
111210100101001
100010001000111
100000002000001
110101001000001
111010000000001
100010001000011
111111111111111
