NO ./assets/world/wall.xpm
SO ./assets/world/wall.xpm
WE ./assets/world/wall.xpm
EA ./assets/world/wall.xpm
F 76,207,114
C 109,21,79
111111111111111
102010020001001
101100011000001
101000100101101
111001001100101
110001111000011
111001000001001
100100121010N01
111000001000011
102001101000001
111000010010001
110100101000001
100011011010001
100011000001001
111111111111111
