NO ./assets/world/wall.xpm
SO ./assets/world/wall.xpm
WE ./assets/world/wall.xpm
EA ./assets/world/wall.xpm

F 14,5,58
C 10,0,10
C 10,0,10

1111111111111
1E00200000001
1111111111111
