NO ./assets/tests/wall.xpm
SO ./assets/tests/wall.xpm
WE ./assets/tests/wall.xpm
EA ./assets/tests/wall.xpm

F 14,5,58
C 1,1,1

11111111111111111
1000S000100000001
10110110101101101
10000000000000001
10110101110101101
10000100100100001
11110110101101111
11110100000101111 11111111
20000001110000001 10000002
11110100000101111 11111111
11110110101101111
10000100100100001
10110101110101101
10000000000000001
10110110101101101
10000000100000001
11111111111111111
